111111111111111111111111111111111111111111111111111111111111
101111100000001101111100000000001100000000001101111100000001
101101111011101101101100011101101101111011101101101100011101
100000000011101100000000011101100000000011101100000000011101
101111111111101101111101111101101111111111101101111111111101
101000001101100001000001101101101000001101100001000001101101
101011101101101101011101101101101011101101100001011101101101
101011101101100001011101101101101011101101100001011101101101
101111101101101101111101101101101111101101101101111101101101
101111101101101101111101101101101111101101101101111101101101
100000001100000000000001100001100000001100000000000001100001
111111001101111011111001101111111111001101111011111001101111
111000001101111011000001101110011000001101111011000001101111
100000000000011000000000000000000000000000011000000000000011
111111111111111111111111111111111111111111111111111111111111